11111111111111111111111111111111
11111111111111111111111111111111
11110000000000000000000000011111
11100000000000000000000000001111
11000000000000000000000000000111
11111111111111011111111111111111
11000000000000000000000000000111
11100000000000000000000000001111
11110000000000000000000000011111
11111111111111111111111111111111
11111111111111111111111111111111