1111111111111111111
11110001C1000001111
1110000000000000111
1100000000000000011
1001010000000000001
1000100000000E00001
1000000000000000001
1100000000000000011
1110000000001P10111
11110000##000100111
1111111111111111111