11111111111111111111111111111111111111
11110000000000000000000C00000000001111
11111111111111111111111111111111111111