1111111111111111111
11110001C0000001111
1110000010010000111
1100000000010001011
10001000100000C0001
1000000001000100001
1001000000000100001
1000C10000000000001
1000100000000000001
1001000010000E11001
1001000C10001100001
1000000100000000001
1100100000110000001
1C00000100000010001
1111010000010000011
1110000010000010111
1111000000C000P1111
1111111111111111111