1111111111111111111
10000000C0000000001
1000000000000000001
1000000000000000001
1000000000000000001
1000000000000E00001
1000000000000000001
1000000000000000001
1000000000000000001
10000000P0000000001
1111111111111111111