1111111111111111111
11110001C1000001111
1110000010000000111
1100100000000000011
1001C10000000000001
1000100000000E00001
1000000000000000001
1100000000000000011
11100000P0000C00111
1111000000000001111
1111111111111111111