1111111111111111111
10000P00C0000E00001
1111111111111111111