1111111111111111111
11110000C0000001111
1111111111111111111