1111111111111111111
11110P00C0000E01111
1111111111111111111