1111111111111111111
11110000C0000001111
1110000000000000111
1100000000000000011
1000C00000000000001
1000000000000E00001
1000000000000000001
1100000000000000011
1110000000000C10111
11110000000000P1111
1111111111111111110